#############################################
#######.##.####..1.!.!......................#
##.........#######..!.......................#
#.#.........######..!#####!...............#.#
#...@........$...#...#......................#
#............$...#!.#.....................####
###############..#..#..#####................##
#..###...##.#....#1.#..#.....................#
#............#..####...#....................#
#..................#...#....................#
#..................##..#....................#
#......................#..............#######
#......................#....................#
#......................#....................#
#############################################

