#############################################
#######.##.#...1..!.........................#
##..........######..!.......................#
#.#.............##..!#####!...............#.#
#...@...........#...#.......................#
#...............#!.#.....................####
##############..#..#..#####................##
#..###...##.#...#1.#..#.....................#
#............#..####...#....................#
#..................#...#....................#
#..................##..#....................#
#......................#....................#
#......................#.................####
#......................#....................#
#############################################

