#########################################
#.....#.##.#...1..!.......................
##..........######..!.....................
#.#.@...........##..!.....!...............
#...............#.........................
##############..#!........................
##..11...#####..#.........................
#............#..#1........................
#.........................................
#.........................................
#.........................................
#.........................................
#.........................................
#.........................................
#.........................................

