#########################################
###...#.##.#...1..!......................#
##..........######..!....................#
#...@...........##..!.....!..............#
#...............#........................#
##############...!####...................#
##.......#####...........................#
#............####1####...................#
#........................................#
#........................................#
#........................................#
#........................................#
#........................................#
#........................................#
#........................................#
##########################################
##########################################