#############################################
###...#######################################
##..........#################################
#...@...........###############..........####
#...............##########...................
####....######...............................
##.######.#####..............................
#............#################.........######
#.................#######################....
#............................................
#...........................................
#...........................................
#...........................................
#...........................................
#...........................................

