#########################################
###...#.##.#...1..!.......................
##..........######..!.....................
#...@...........##..!.....!...............
#...............#.........................
##############...!####....................
##.......#####............................
#............####1####....................
#.........................................
#.........................................
#.........................................
#.........................................
#.........................................
#.........................................
#.........................................

