#############################################
###...#######################################
##..........#################################
#...@...........#############################
#...............##########...................
####....######...............................
##.######.#####..............................
#............################################
#.................#############.............
#............................................
#...........................................
#...........................................
#...........................................
#...........................................
#...........................................

